      01234567890123456789
   0  ||XXXXXXXXXXXXXXXXXX
   1  |XOOOOEOOOOOX|||B||X
   2  XOOOOOOOOOOOOX|||||X
   3  XOOEOOEOOEOOOOX||||X
   4  XOOOOOOOOOOEOOX||||X
   5  XEEOOOOOOOOOOOX||||X
   6  XCEOOOOOEOOCOOOX|||X
   7  XEEOOOOEOCOOOOOOXXXX
   8  XOOOOOOOOOOOOOOOEOCX
   9  XOOOOOOOOOOOOOEOOOOX
   0  XCOOOOOEOOOOOOOEOOCX
   1  XOOOOXXCEOOOOOOOOOCX
   2  XOOOOXXCEOOOOOOXXXX|
   3  XOOOOOOEOOOOOOXX||||
   4  |XCOOOOOOOECOOOOXXX|
   5  XHOOOOOOOOOOOOEOOOCX
   6  |XOOEOOOOOOOOOOOOOOX
   7  XOOOOOXXXXXCEOOOOEOX
   8  XOCEEX|||||XXOOEOCOX
   9  XXXXX||||||||XXXXXXX
      01234567890123456789
